*******************************************************************************************************************************************************
S     *  *        *        *        *        *        *                       *        *        *     *                    *        *     *     *     *
****  *  *  *  *  *  ****  *  ****  *  ****  *  *  *  *  *******************  *  ****  *  ****  *  *  *  *******  *******  *  ****  *  *  *  *  ****  *
*     *     *  *     *        *  *  *  *  *     *  *  *  *                 *     *     *  *     *  *  *  *     *  *     *  *  *  *  *  *  *  *     *  *
*  **********  *******  *  ****  *  *  *  *******  ****  *  **********  **********  *******  ****  *  ****  *  *  *  *  *  *  *  *  *  ****  ****  *  *
*              *        *     *     *  *  *        *     *     *     *              *              *        *  *     *  *  *     *           *     *  *
****************  **********  *******  *  *  *******  ****  *  *  *  ****  ****  ****  **********************  *  ****  *  **********  **********  *  *
*  *           *  *     *           *  *     *     *  *  *  *  *  *  *  *  *     *     *  *                 *  *  *     *           *     *        *  *
*  *  *******  *  *  *  ****  *******  *******  *  *  *  *  *  ****  *  *  *******  ****  *  *************  *  *  *  *************  *  *  *  *******  *
*        *     *  *  *  *        *     *     *  *     *     *  *     *     *     *     *     *           *  *  *  *        *        *  *  *           *
****  *  *  ****  *  *  *  *******  ****  *  *  *************  *  **********  *  ****  *************  ****  *  *************  *******  ****************
*     *  *     *     *  *  *     *     *  *  *     *        *     *        *  *  *              *     *     *        *     *              *           *
*  ****  *************  *  *  *  *  *  *  *******  *  ****  *******  *  *  *  *  *  **********  *  ****  **********  *  *  **********  *  **********  *
*  *  *     *           *     *     *        *  *  *     *     *     *  *  *  *  *  *        *  *     *  *        *  *  *              *           *  *
*  *  *  *  *  *************  *************  *  *  *  *******  **********  *  *  ****  ****  *  *  *  *  *  *******  *  *******************  *******  *
*     *  *     *           *     *              *  *        *           *  *  *     *  *  *     *  *  *  *        *  *              *  *              *
*******  *******  *  ****  ****  *  *************  *******************  *  *******  *  *  *  *  *  *  *  *******  *  *************  *  *  *************
*        *        *  *  *  *     *  *           *     *  *     *     *        *        *  *  *     *  *           *              *     *  *  *        *
*  *******  *******  *  *  *  ****  *  *******  ****  *  *  *  ****  *******  ****  *  *  *  *******  **********  ****  *******  *******  *  *  ****  *
*     *     *     *  *     *     *  *  *     *  *  *  *     *     *  *     *     *  *  *     *        *        *        *        *     *     *     *  *
****  *  *******  ****  **********  *  *  *  *  *  *  *  *  ****  *  *  *  ****  *  **********  *******  ****************************  ****  ****  ****
*     *        *     *  *        *     *  *  *  *     *  *  *     *  *  *  *     *     *        *     *                    *        *  *     *        *
*  **********  *  *  *  *  ****  *******  *  *  *  ****  *  *  ****  *  *  *  *******  *  *******  *  *************  ****  *  ****  *  *  ****  *  *  *
*        *     *  *  *  *     *     *     *     *  *     *  *     *  *  *     *        *  *        *  *           *  *     *     *  *  *     *  *  *  *
*******  *  ****  *  *  *  *******  *  *  *******  *  *  *******  *  *  *******  ****  *  *  *  ****  *  ****  ****  *  **********  *  *  ****  ****  *
*        *     *  *  *  *     *     *  *        *  *  *  *           *  *     *  *     *  *  *     *  *  *     *     *        *     *        *  *     *
*  **********  *  *  *  ****  *******  *******  *  *  ****  ****  ****  ****  *  *  ****  *  ****  *  ****  ****  **********  *  **********  *  *  ****
*     *     *  *  *        *  *        *     *        *     *  *     *  *     *  *     *     *     *  *     *        *        *           *  *  *     *
*  ****  *  ****  **********  *  *******  *  ****  ****  ****  ****  *  *  ****  ****  *******  *  *  *  *******  *  *  *******  *******  *  ****  *  *
*  *     *        *        *  *        *  *  *     *  *  *        *     *  *        *        *  *  *     *     *  *  *                 *     *     *  *
*  *  *  **********  ****  *  *  ****  *  ****  ****  *  ****  *  *******  *  *************  *  *  **********  *  *  ****  ****  ****  *******  ****  *
*  *  *        *     *     *        *  *     *     *  *     *  *     *     *  *  *     *     *  *  *           *  *  *  *  *     *              *     *
*  *  *******  *  ****  *************  ****  ****  *  *  *  *  ****  *  ****  *  *  *  *  *  *  ****  ****  *******  *  *  *  *******************  ****
*  *        *  *     *     *        *     *        *     *        *     *     *     *     *  *        *  *           *     *  *           *     *     *
*  **********  ****  ****  *  ****  ****  *******************  *  *******  ****************************  ****  *  **********  *  *******  *  *  ****  *
*     *     *     *     *  *  *  *        *  *     *  *        *  *        *     *     *     *           *     *  *           *  *     *     *     *  *
****  *  *  ****  *******  *  *  **********  *  *  *  *  *******  *  *******  *  *  *  ****  *  *******************  **********  ****  **********  *  *
*     *  *        *        *  *  *     *        *     *  *        *     *     *     *     *  *        *  *        *  *        *     *     *        *  *
****  *  **********  *******  *  *  ****  *******  ****  *************  ****************  *  *******  *  *  ****  *  *  ****  ****  ****  ****  ****  *
*     *     *     *  *     *  *  *  *     *  *     *  *     *                 *  *        *  *  *     *     *  *     *  *  *     *     *           *  *
*  *******  *  *  *  ****  *  *  *  *  *  *  *  ****  ****  *  *******  ****  *  *  *******  *  *  **********  *******  *  ****  ****  **********  *  *
*     *     *  *           *        *  *     *     *     *        *     *        *  *     *     *        *  *  *        *  *  *        *  *        *  *
****  ****  *  ****  **********  *  **********  *******  *******  *  *******  ****  *  *  ****  *******  *  *  *  *******  *  ****  ****  *  *******  *
*  *     *  *  *  *        *     *        *  *        *  *     *  *     *           *  *  *     *           *  *     *     *     *        *  *     *  *
*  ****  *  *  *  *******  *  **********  *  *******  *  *  ****  *  *  *  **********  *  *  ****  ****  ****  ****  *  *******  **********  *  ****  *
*  *           *        *  *  *     *     *     *     *     *     *  *  *  *     *     *     *     *     *     *     *        *  *        *  *  *     *
*  *******  ****  *******  *  *  *  *  ****  *  *  *******  *  *******  *  ****  *  ****************  ****  ****  *******  *  *  *  *  ****  *  *  ****
*        *     *           *     *  *  *     *     *     *     *        *           *              *     *     *           *     *  *        *  *  *  *
*******  *  **********************  *  *  *************  *******************  *  ****  *******  *  ****  ****  *******************  *  *******  *  *  *
*        *     *           *        *     *     *     *     *        *     *  *     *        *  *        *                 *     *  *  *           *  *
*  **********  *  *******  *  *******  *  *  *  *  *  ****  *******  *  *  *******  *******  *************  *******  ****  *  *  *  *  *  *  *******  *
*        *     *  *        *  *  *     *  *  *  *  *     *           *  *     *  *  *     *     *           *     *     *  *  *  *  *  *  *     *     *
****  *  *  *******  *******  *  *  *******  *  *  ****  ****  *************  *  *  *  *  ****  *************  *  *  ****  *  *  *  *  *******  *  *  *
*     *     *     *  *  *     *     *        *  *     *  *  *  *           *  *     *  *  *     *              *  *  *     *  *  *  *     *  *     *  *
*  **********  *  *  *  *  **********  *******  ****  *  *  *  *  *******  *  *  ****  *  *  *  *  *************  ****  ****  *  *  ****  *  **********
*        *     *     *     *              *     *     *        *  *     *  *  *     *  *  *  *  *  *              *     *     *  *     *  *  *        *
****  *  *  ****  **********  *************  ****  *************  *  ****  *  ****  *  *  *  *  *  *  *  **********  **********  ****  *  *  *  ****  *
*     *     *     *                       *        *        *     *     *     *     *  *     *  *  *  *     *     *  *        *  *     *     *     *  *
*  **********  ****  *******************  ****  **********  *  *******  *******  ****  *******  *  *******  *  *  *  *  *  ****  *  ****  **********  *
*     *     *  *     *                 *     *  *     *     *        *        *  *     *  *     *     *  *  *  *  *  *  *           *     *     *     *
****  ****  *  *  ****  **********  *******  *  *  *  *  **********  *******  *  *  ****  *  *******  *  *  *  *  *  *  *******  ****  *******  *  ****
*     *     *  *     *     *     *           *  *  *        *                 *  *  *        *     *  *     *  *     *        *  *     *     *  *     *
*  ****  ****  ****  ****  *  *  *************  *  **********  *******  *******  *  *  *******  *  *  *  ****  ****************  *  *******  *  ****  *
*     *  *  *        *     *  *  *     *        *  *           *        *     *     *  *        *     *        *     *           *     *     *        *
*  *  *  *  **********  ****  *  *  *  *  ****  *  *  **********  *******  *  *******  ****  *******  **********  *  *  *************  *  *******  ****
*  *  *  *  *     *     *     *  *  *  *     *     *     *     *  *  *     *        *  *           *     *  *     *     *  *           *     *     *  *
*  *  *  *  *  *  *  **********  *  *  ****  **********  *  *  *  *  *  **********  *  *  *  ****  ****  *  *  **********  *  *******  ****  *  ****  *
*  *  *     *  *  *     *     *     *     *     *           *  *  *  *     *     *  *     *     *  *  *        *     *  *  *  *           *  *        *
*  *  *  *******  ****  *  *  **********  ****  *  *************  *  ****  *  *  *  *************  *  ****  *******  *  *  *  *  ****  ****  *  *******
*  *     *     *     *  *  *           *     *  *        *     *  *  *  *     *  *  *     *        *     *           *        *     *        *  *     *
*  *******  *  ****  *  *  **********  ****  *  *******  *  *  *  *  *  ****  *  ****  *  *  ****  ****  ****************  *******  **********  *  ****
*     *  *  *        *     *           *  *  *  *        *  *  *  *  *     *  *        *     *     *  *        *        *  *        *     *  *  *     *
****  *  *  *******  *******  ****  ****  *  *  *  **********  *  *  ****  *************  ****  ****  *******  *******  ****  *******  *  *  *  *  *  *
*  *  *     *  *           *     *  *        *  *  *  *     *     *  *           *     *  *     *           *        *        *        *  *        *  *
*  *  ****  *  *  *************  *  *  *******  *  *  *  *  *  ****  *  *  *******  *  *  *******  *******  ****  *  *******************  ****  ****  *
*     *     *     *     *        *  *  *        *     *  *  *  *  *  *  *     *     *     *     *     *        *  *  *     *           *  *  *     *  *
*  ****  **********  *  *  **********  *  *************  *  *  *  *  *  ****  *  **********  *  ****  *  ****  ****  *  *  *  ****  ****  *  ****  *  *
*        *        *  *        *     *  *     *        *  *        *  *     *     *     *  *  *     *  *  *     *     *  *     *  *     *        *  *  *
****************  *  **********  *  *  ****  *  ****  *  *  *******  ****  *******  *  *  *  ****  ****  *  ****  ****  *******  ****  *  *******  *  *
*     *        *  *  *           *  *  *  *     *        *        *  *     *        *  *  *     *        *  *        *  *     *        *     *     *  *
*  *  *******  *  *  *  **********  *  *  *******  ****  *******  *  *  ****  *******  *  ****  **********  *  *  ****  *  *  **********  *  *  ****  *
*  *        *  *  *        *        *  *        *     *        *  *  *        *        *     *     *        *  *           *              *     *     *
*  *******  *  *  ****  *  *  *******  *******  ****  *  ****  *  *  **********  *  *  ****  ****  *  ****************************  *******************
*  *        *  *        *  *           *              *  *     *     *        *  *  *              *     *     *           *     *  *                 *
*  **********  **********  ****  *************************  **********  ****  *  **********  **********  ****  *  ****  *  *  ****  ****************  *
*              *        *  *     *              *        *     *  *     *  *  *           *  *     *           *     *  *  *           *              *
*******  *  ****  ****  *  *  ****  **********  *******  ****  *  *  ****  *  *************  *  *  *******************  *************  *************  *
*     *  *        *  *  *  *  *     *        *  *     *  *     *  *  *     *     *  *        *  *     *        *     *           *        *        *  *
*  ****  **********  *  ****  *  ****  ****  *  *  *  *  *  ****  *  *  ****  *  *  *  *******  ****  *  ****  *  *  **********  *  ****  *  ****  *  *
*        *     *     *           *     *     *  *  *     *     *  *        *  *     *     *     *     *     *     *     *     *  *  *     *  *  *  *  *
**********  *  *  *  *******  ****  **********  *  **********  *  ****  *  *  ****  ****  *  ****  ****  *  *  ****  *  *  *  *  ****  ****  *  *  *  *
*     *     *     *  *        *                 *  *        *  *  *     *  *  *  *        *  *     *     *  *  *     *     *  *     *     *  *  *  *  *
*  *  *  **********  ****  **********************  *******  *  *  *  ****  *  *  ****  ****  *  **********  ****  **********  *  *  *  *  *  *  *  *  *
*  *     *     *  *        *           *        *  *           *     *     *  *        *     *  *     *     *     *  *        *  *  *  *  *  *     *  *
*  *******  *  *  *  *  *******  ****  *  ****  *  *  ****************  *******  *******  ****  ****  *  ****  ****  *  **********  ****  *  ****  *  *
*  *        *     *  *  *     *     *     *        *     *        *     *     *        *  *  *           *  *        *     *              *  *     *  *
*  *  *************  ****  *  ****  *******  **********  *  *  ****  ****  *  *******  *  *  *************  *******  ****  *  ****  *******  *  ****  *
*  *     *  *     *        *     *  *     *        *  *     *     *  *     *     *  *  *     *              *        *     *  *     *     *  *     *  *
*  ****  *  *  *  *******  *  *  *  *  **********  *  **********  *  *  ****  *  *  *  *  *  *  *************  *******  ****  *  *******  *  ****  *  *
*        *     *           *  *     *              *              *     *     *     *     *  *                 *              *                 *     E
*******************************************************************************************************************************************************